{
  "width": 21,
  "height": 21,
  "data":
    [
		200, 200, 200, 200, 200, 200, 200, 200, 200, 200, 200, 200, 200, 200, 200, 200, 200, 200, 200, 200, 200,
		200, 200, 200, 200, 200, 200, 200, 200, 200, 120, 200, 200, 200, 200, 200, 200, 200, 200, 200, 200, 200,
		200, 200, 200, 200, 200, 200, 200, 200, 200, 110, 210, 200, 200, 200, 200, 200, 200, 200, 200, 200, 200,
		200, 200, 200, 200, 200, 200, 200, 200, 100, 110, 110, 200, 200, 200, 200, 200, 200, 200, 200, 200, 200,
		200, 200, 200, 200, 200, 200, 200, 200, 100, 100, 100, 200, 200, 200, 200, 200, 200, 200, 200, 200, 200,
		200, 200, 200, 200, 200, 200, 200, 200, 100, 100, 100, 200, 200, 200, 200, 200, 200, 200, 200, 200, 200,
		200, 200, 200, 200, 200, 200, 200, 200, 100, 100, 100, 200, 200, 200, 200, 200, 200, 200, 200, 200, 200,
		200, 200, 200, 200, 200, 200, 200, 200, 100, 100, 200, 200, 200, 200, 200, 200, 200, 200, 200, 200, 200,
		200, 200, 200, 200, 200, 200, 200, 100, 100, 100, 100, 100, 200, 200, 200, 200, 200, 200, 200, 200, 200,
		200, 200, 200, 200, 200, 200, 200, 200, 100, 100, 100, 100, 200, 200, 200, 200, 200, 200, 200, 200, 200,
		200, 200, 200, 200, 200, 200, 200, 210, 100, 100, 100, 100, 210, 200, 200, 200, 200, 200, 200, 200, 200,
		200, 200, 200, 200, 200, 200, 200, 210, 100, 100, 100, 100, 100, 100, 100, 200, 200, 200, 200, 200, 200,
		200, 200, 200, 200, 200, 210, 100, 100, 100, 100, 100, 100, 100, 100, 100, 200, 200, 200, 200, 200, 200,
		200, 200, 200, 200, 200, 200, 200, 100, 100, 100, 100, 100, 100, 100, 200, 200, 200, 200, 200, 200, 200,
		200, 200, 200, 200, 200, 200, 200, 100, 100, 100, 100, 100, 100, 200, 200, 200, 200, 200, 200, 200, 200,
		200, 200, 200, 200, 200, 200, 200, 200, 200, 100, 100, 200, 200, 200, 200, 200, 200, 200, 200, 200, 200,
		200, 200, 200, 200, 200, 200, 200, 200, 200, 100, 100, 200, 200, 200, 200, 200, 200, 200, 200, 200, 200,
		200, 200, 200, 200, 200, 200, 200, 200, 200, 100, 100, 200, 200, 200, 200, 200, 200, 200, 200, 200, 200,
		200, 200, 200, 200, 200, 200, 200, 200, 200, 100, 100, 200, 200, 200, 200, 200, 200, 200, 200, 200, 200,
		200, 200, 200, 200, 200, 200, 200, 200, 200, 110, 100, 200, 200, 200, 200, 200, 200, 200, 200, 200, 200,
		200, 200, 200, 200, 200, 200, 200, 200, 200, 120, 120, 200, 200, 200, 200, 200, 200, 200, 200, 200, 200
    ],
  "content": {
    "10*": "walkable",
    "11*": "wevent",
    "20*": "unwalkable",
    "21*": "uevent",
    "*": "height"
  },
   "born": [9.5, 1.5],
   "NPC": [238, 217, 52]
}
