{
"width": 30,
"height": 30,
"data":
	[
		200, 200, 200, 200, 120, 120, 200, 200, 200, 200, 200, 200, 200, 200, 200, 200, 200, 200, 200, 200, 200, 200, 200, 200, 200, 200, 200, 200, 200, 200,
		200, 200, 200, 200, 100, 100, 200, 200, 200, 200, 200, 200, 200, 200, 200, 200, 200, 200, 200, 200, 200, 200, 200, 200, 200, 200, 200, 200, 200, 200,
		200, 200, 200, 200, 100, 100, 200, 200, 200, 200, 200, 200, 200, 200, 200, 200, 200, 200, 200, 200, 200, 200, 200, 200, 200, 200, 200, 200, 200, 200,
		200, 200, 200, 200, 100, 100, 200, 200, 200, 200, 200, 200, 200, 200, 200, 200, 200, 200, 200, 200, 200, 200, 200, 200, 200, 200, 200, 200, 200, 200,
		200, 200, 200, 200, 100, 100, 100, 200, 200, 200, 200, 200, 200, 200, 200, 200, 100, 100, 200, 200, 200, 200, 100, 100, 200, 200, 200, 200, 200, 200,
		200, 200, 100, 210, 100, 100, 210, 200, 200, 200, 200, 200, 200, 100, 200, 100, 100, 100, 100, 200, 200, 100, 100, 100, 200, 200, 200, 200, 200, 200,
		200, 200, 100, 100, 100, 100, 100, 100, 100, 200, 200, 200, 200, 100, 100, 210, 210, 100, 100, 100, 100, 100, 200, 200, 200, 200, 200, 200, 200, 200,
		200, 100, 100, 100, 100, 100, 200, 100, 100, 200, 200, 200, 100, 100, 100, 100, 100, 100, 100, 200, 200, 200, 200, 200, 200, 200, 200, 200, 200, 200,
		200, 200, 200, 100, 100, 100, 100, 100, 100, 100, 100, 100, 100, 200, 100, 100, 100, 200, 200, 200, 200, 200, 200, 200, 200, 200, 200, 200, 200, 200,
		200, 200, 200, 200, 100, 100, 200, 100, 100, 200, 200, 200, 200, 200, 200, 100, 200, 100, 100, 200, 200, 200, 200, 200, 200, 200, 200, 200, 200, 200,
		200, 200, 200, 100, 100, 100, 100, 100, 200, 200, 200, 200, 200, 200, 200, 100, 100, 100, 100, 200, 200, 200, 200, 200, 200, 200, 200, 200, 200, 200,
		200, 200, 200, 200, 200, 200, 200, 200, 200, 200, 200, 200, 200, 200, 100, 100, 100, 100, 200, 200, 200, 200, 200, 200, 200, 200, 200, 200, 200, 200,
		200, 200, 200, 200, 200, 200, 200, 200, 200, 200, 200, 200, 200, 200, 200, 100, 200, 200, 200, 200, 200, 200, 200, 200, 200, 200, 200, 200, 200, 200,
		200, 200, 200, 200, 200, 200, 200, 200, 200, 200, 200, 200, 200, 200, 200, 100, 200, 200, 200, 200, 200, 200, 200, 200, 200, 200, 200, 200, 200, 200,
		200, 200, 200, 200, 200, 200, 200, 200, 200, 200, 200, 200, 200, 200, 200, 100, 200, 200, 200, 200, 200, 200, 200, 200, 200, 200, 200, 200, 200, 200,
		200, 200, 200, 200, 200, 200, 200, 200, 200, 200, 200, 200, 200, 200, 200, 100, 200, 200, 200, 200, 200, 200, 200, 200, 200, 200, 200, 200, 200, 200,
		200, 200, 200, 200, 200, 200, 200, 200, 200, 200, 200, 200, 200, 200, 200, 100, 200, 200, 200, 200, 200, 200, 200, 200, 200, 200, 200, 200, 200, 200,
		200, 200, 200, 200, 200, 200, 200, 200, 200, 200, 200, 200, 200, 200, 200, 100, 200, 200, 200, 200, 200, 200, 200, 200, 200, 200, 200, 200, 200, 200,
		200, 200, 200, 200, 200, 200, 200, 200, 200, 200, 200, 200, 200, 200, 200, 100, 200, 200, 200, 200, 200, 200, 200, 200, 200, 200, 200, 200, 200, 200,
		200, 200, 200, 200, 200, 200, 200, 200, 200, 200, 200, 200, 200, 200, 200, 100, 200, 100, 100, 200, 210, 200, 200, 200, 200, 200, 200, 200, 200, 200,
		200, 102, 200, 102, 102, 102, 200, 200, 200, 200, 200, 200, 200, 200, 200, 100, 200, 100, 100, 200, 100, 200, 100, 200, 200, 200, 200, 200, 200, 200,
		200, 102, 102, 102, 100, 200, 210, 100, 100, 100, 100, 100, 100, 100, 200, 110, 200, 100, 200, 100, 100, 100, 100, 200, 200, 200, 200, 200, 200, 200,
		200, 102, 102, 102, 100, 100, 100, 100, 100, 100, 100, 100, 100, 100, 100, 100, 200, 100, 100, 100, 100, 100, 100, 200, 200, 200, 200, 200, 200, 200,
		200, 102, 102, 102, 100, 100, 100, 100, 200, 100, 100, 100, 100, 100, 100, 100, 200, 200, 100, 100, 100, 200, 100, 200, 200, 200, 200, 200, 200, 200,
		200, 200, 101, 210, 200, 200, 200, 100, 100, 100, 100, 100, 100, 100, 100, 100, 200, 200, 100, 200, 200, 200, 200, 200, 200, 200, 200, 200, 200, 200,
		120, 100, 100, 100, 100, 200, 100, 100, 100, 100, 100, 100, 200, 200, 200, 100, 100, 100, 100, 200, 200, 200, 200, 200, 200, 200, 200, 200, 200, 200,
		200, 200, 200, 100, 100, 200, 100, 100, 200, 100, 100, 100, 200, 200, 200, 100, 100, 100, 100, 100, 100, 200, 200, 200, 200, 200, 200, 200, 200, 200,
		200, 200, 200, 100, 100, 100, 100, 100, 200, 100, 200, 200, 200, 200, 200, 200, 200, 200, 100, 100, 100, 200, 200, 200, 200, 200, 200, 200, 200, 200,
		200, 200, 200, 200, 100, 100, 100, 200, 200, 200, 200, 200, 200, 200, 200, 200, 200, 200, 200, 200, 100, 200, 200, 200, 200, 200, 200, 200, 200, 200,
		200, 200, 200, 200, 200, 200, 200, 200, 200, 200, 200, 200, 200, 200, 200, 200, 200, 200, 200, 200, 200, 200, 200, 200, 200, 200, 200, 200, 200, 200
	],
"content": {
    "10*": "walkable",
    "11*": "wevent",
    "20*": "unwalkable",
    "21*": "uevent",
    "*": "height"
},
"born": [5, 28],
"NPC":[153, 636]
}
