{
  "width": 29,
  "height": 29,
  "data":
    [
		200, 200, 200, 200, 200, 200, 200, 200, 200, 200, 200, 200, 200, 200, 200, 200, 200, 200, 200, 200, 200, 200, 200, 200, 200, 200, 200, 200, 200,
		200, 200, 200, 200, 200, 200, 200, 200, 200, 200, 200, 200, 200, 200, 200, 200, 200, 200, 200, 200, 200, 200, 200, 200, 200, 200, 200, 200, 200,
		200, 200, 200, 200, 200, 200, 200, 200, 200, 200, 200, 200, 200, 200, 200, 200, 200, 200, 200, 200, 200, 200, 200, 200, 200, 200, 200, 200, 200,
		200, 200, 200, 200, 200, 200, 200, 200, 200, 200, 200, 200, 200, 200, 210, 200, 200, 200, 200, 200, 200, 200, 200, 200, 200, 200, 200, 200, 200,
		200, 200, 100, 100, 100, 100, 100, 100, 100, 100, 100, 100, 200, 210, 110, 100, 200, 100, 100, 110, 100, 100, 100, 100, 100, 100, 100, 100, 200,
		200, 100, 100, 100, 100, 100, 100, 100, 100, 100, 100, 100, 200, 110, 110, 100, 100, 100, 100, 110, 100, 100, 100, 100, 100, 100, 100, 100, 200,
		200, 100, 100, 200, 100, 100, 200, 100, 200, 200, 100, 100, 200, 100, 100, 100, 200, 100, 200, 200, 100, 100, 200, 200, 200, 200, 200, 200, 200,
		200, 100, 100, 200, 100, 100, 100, 200, 100, 100, 110, 100, 200, 100, 200, 200, 200, 200, 100, 100, 100, 100, 100, 100, 100, 200, 100, 100, 200,
		200, 100, 100, 200, 100, 100, 100, 100, 100, 100, 110, 100, 100, 200, 100, 100, 100, 100, 100, 100, 100, 100, 100, 100, 100, 100, 200, 100, 200,
		200, 100, 100, 200, 100, 100, 200, 200, 100, 200, 200, 200, 200, 200, 100, 100, 200, 100, 100, 200, 100, 100, 200, 100, 100, 200, 100, 100, 200,
		200, 100, 100, 200, 100, 100, 100, 100, 200, 100, 100, 100, 200, 100, 100, 100, 100, 100, 200, 200, 200, 200, 200, 200, 200, 200, 200, 100, 200,
		200, 100, 100, 100, 100, 100, 100, 100, 100, 100, 100, 100, 200, 100, 100, 100, 100, 100, 100, 110, 100, 100, 100, 100, 200, 200, 200, 100, 200,
		200, 200, 200, 200, 200, 200, 200, 100, 100, 200, 200, 200, 200, 200, 200, 200, 200, 200, 200, 200, 100, 100, 200, 100, 200, 200, 200, 100, 200,
		200, 100, 100, 100, 100, 100, 100, 100, 100, 100, 100, 100, 100, 100, 200, 100, 100, 100, 100, 200, 100, 100, 200, 100, 200, 200, 200, 100, 200,
		200, 100, 100, 100, 100, 100, 100, 100, 100, 100, 100, 100, 100, 100, 100, 100, 100, 100, 200, 200, 100, 100, 200, 100, 100, 100, 100, 100, 200,
		200, 100, 100, 200, 200, 200, 200, 200, 200, 200, 200, 200, 200, 200, 200, 200, 200, 200, 200, 200, 200, 100, 200, 100, 100, 200, 100, 100, 200,
		200, 100, 100, 100, 100, 100, 100, 100, 100, 100, 100, 100, 100, 100, 100, 100, 100, 100, 100, 100, 100, 100, 100, 100, 100, 100, 100, 100, 200,
		200, 100, 100, 100, 100, 100, 100, 100, 100, 100, 100, 100, 100, 100, 100, 100, 100, 100, 100, 100, 100, 100, 100, 100, 100, 100, 100, 100, 200,
		200, 200, 200, 200, 200, 200, 200, 200, 200, 200, 200, 200, 200, 100, 100, 100, 200, 200, 200, 200, 200, 200, 200, 200, 200, 200, 200, 200, 200,
		200, 200, 200, 200, 200, 200, 200, 200, 200, 200, 200, 200, 200, 100, 100, 100, 200, 200, 200, 200, 200, 200, 200, 200, 200, 200, 200, 200, 200,
		200, 200, 200, 200, 200, 200, 200, 200, 200, 200, 200, 200, 200, 200, 110, 200, 200, 200, 200, 200, 200, 200, 200, 200, 200, 200, 200, 200, 200,
		200, 200, 200, 200, 200, 200, 200, 200, 200, 200, 100, 100, 100, 100, 100, 100, 100, 100, 100, 200, 200, 200, 200, 200, 200, 200, 200, 200, 200,
		200, 200, 200, 200, 200, 200, 200, 200, 200, 200, 100, 100, 100, 100, 100, 100, 100, 100, 100, 200, 200, 200, 200, 200, 200, 200, 200, 200, 200,
		200, 200, 200, 200, 200, 200, 200, 200, 200, 200, 100, 100, 100, 100, 100, 100, 100, 100, 100, 200, 200, 200, 200, 200, 200, 200, 200, 200, 200,
		200, 200, 200, 200, 200, 200, 200, 200, 200, 200, 200, 200, 200, 100, 100, 100, 200, 200, 200, 200, 200, 200, 200, 200, 200, 200, 200, 200, 200,
		200, 200, 200, 200, 200, 200, 200, 200, 200, 200, 200, 200, 200, 100, 100, 100, 200, 200, 200, 200, 200, 200, 200, 200, 200, 200, 200, 200, 200,
		200, 200, 200, 200, 200, 200, 200, 200, 200, 200, 200, 200, 200, 100, 100, 100, 200, 200, 200, 200, 200, 200, 200, 200, 200, 200, 200, 200, 200,
		200, 200, 200, 200, 200, 200, 200, 200, 200, 200, 200, 200, 200, 100, 110, 100, 200, 200, 200, 200, 200, 200, 200, 200, 200, 200, 200, 200, 200,
		200, 200, 200, 200, 200, 200, 200, 200, 200, 200, 200, 200, 200, 120, 120, 120, 200, 200, 200, 200, 200, 200, 200, 200, 200, 200, 200, 200, 200
    ],
  "content": {
    "10*": "walkable",
    "11*": "wevent",
    "20*": "unwalkable",
    "21*": "uevent",
    "*": "height"
  },
  "born": [14.5, 1.5],
  "NPC": [129]
}
