{
  "width": 19,
  "height": 19,
  "data": [
    200, 200, 200, 200, 100, 200, 100, 200, 100, 100, 100, 200, 100, 200, 100, 200, 200, 200, 200,
    200, 200, 200, 200, 100, 200, 100, 200, 100, 100, 100, 200, 100, 200, 100, 200, 200, 200, 200,
    200, 200, 200, 100, 100, 100, 100, 100, 100, 100, 100, 100, 100, 100, 100, 100, 200, 200, 200,
    200, 200, 200, 100, 100, 200, 100, 100, 100, 100, 100, 100, 100, 200, 100, 100, 200, 200, 200,
    200, 200, 200, 100, 100, 100, 100, 100, 100, 110, 100, 100, 100, 100, 100, 100, 200, 200, 200,
    200, 200, 200, 100, 100, 200, 100, 100, 100, 100, 100, 100, 100, 200, 100, 100, 200, 200, 200,
    200, 200, 200, 100, 100, 100, 100, 200, 100, 100, 100, 200, 100, 100, 100, 100, 200, 200, 200,
    200, 200, 200, 100, 100, 100, 100, 100, 100, 100, 100, 100, 200, 100, 100, 100, 200, 200, 200,
    200, 200, 200, 200, 200, 200, 200, 200, 100, 100, 100, 200, 200, 200, 200, 200, 200, 200, 200,
    200, 200, 200, 200, 200, 200, 200, 200, 100, 100, 100, 200, 200, 200, 200, 200, 200, 200, 200,
    200, 200, 200, 100, 100, 100, 100, 200, 100, 100, 100, 100, 100, 100, 100, 200, 200, 200, 200,
    200, 200, 200, 100, 200, 100, 100, 100, 100, 100, 100, 100, 100, 100, 100, 100, 200, 200, 200,
    200, 200, 200, 200, 100, 100, 100, 100, 100, 100, 100, 200, 100, 100, 100, 100, 200, 200, 200,
    200, 200, 200, 100, 100, 100, 100, 200, 100, 100, 100, 200, 100, 100, 200, 100, 200, 200, 200,
    200, 200, 200, 200, 200, 200, 100, 100, 100, 100, 100, 100, 100, 200, 200, 200, 200, 200, 200,
    200, 200, 200, 200, 200, 200, 100, 100, 100, 100, 100, 100, 100, 200, 200, 200, 200, 200, 200,
    200, 200, 200, 200, 200, 200, 100, 200, 100, 100, 100, 200, 100, 200, 200, 200, 200, 200, 200,
    200, 200, 200, 200, 200, 200, 200, 200, 100, 100, 100, 200, 200, 200, 200, 200, 200, 200, 200,
    200, 200, 200, 200, 200, 200, 200, 200, 120, 120, 120, 200, 200, 200, 200, 200, 200, 200, 200
  ],
  "content": {
    "10*": "walkable",
    "11*": "wevent",
    "20*": "unwalkable",
    "21*": "uevent",
    "*": "height"
  },
  "born": [9.5, 14.5]
}

