{
  "width": 37,
  "height": 37,
  "data":
    [
      200, 200, 200, 200, 200, 200, 200, 200, 200, 200, 200, 200, 200, 200, 200, 200, 200, 200, 200, 200, 200, 200, 200, 200, 200, 200, 200, 200, 200, 200, 200, 200, 200, 200, 200, 200, 200,
      200, 200, 200, 200, 200, 200, 200, 200, 200, 200, 200, 200, 200, 200, 200, 200, 200, 200, 200, 200, 200, 200, 200, 200, 200, 200, 200, 200, 200, 200, 200, 200, 200, 200, 200, 200, 200,
      200, 200, 200, 200, 200, 200, 200, 200, 200, 200, 200, 200, 200, 200, 200, 200, 200, 200, 200, 200, 200, 200, 200, 200, 200, 200, 200, 200, 200, 200, 200, 200, 200, 200, 200, 200, 200,
      200, 200, 200, 200, 200, 200, 200, 200, 200, 200, 200, 200, 200, 200, 200, 200, 200, 200, 200, 200, 200, 200, 200, 200, 200, 200, 200, 200, 200, 200, 200, 200, 200, 200, 200, 200, 200,
      200, 200, 200, 200, 200, 200, 200, 200, 200, 200, 200, 200, 200, 200, 200, 200, 200, 200, 200, 200, 200, 200, 200, 200, 200, 200, 200, 200, 200, 200, 200, 200, 200, 200, 200, 200, 200,
      200, 200, 200, 200, 200, 200, 200, 200, 200, 200, 200, 200, 200, 200, 200, 200, 200, 200, 200, 200, 200, 200, 200, 200, 200, 200, 200, 200, 200, 200, 200, 200, 200, 200, 200, 200, 200,
      200, 200, 200, 200, 200, 200, 200, 200, 200, 200, 200, 200, 200, 200, 200, 200, 200, 200, 200, 200, 200, 200, 200, 200, 200, 200, 200, 200, 200, 200, 200, 200, 200, 200, 200, 200, 200,
      200, 200, 200, 200, 200, 200, 200, 200, 200, 200, 200, 200, 200, 200, 200, 200, 200, 200, 200, 200, 200, 200, 200, 200, 200, 200, 200, 200, 200, 200, 200, 200, 200, 200, 200, 200, 200,
      200, 200, 200, 200, 200, 200, 200, 200, 200, 200, 200, 200, 200, 200, 200, 200, 200, 200, 200, 200, 200, 200, 200, 200, 200, 200, 200, 200, 200, 200, 200, 200, 200, 200, 200, 200, 200,
      200, 200, 200, 200, 200, 200, 200, 200, 200, 200, 200, 200, 200, 200, 200, 200, 200, 200, 200, 200, 200, 200, 200, 200, 200, 20, 100, 100, 200, 200, 200, 200, 200, 200, 200, 200, 200,
      200, 200, 200, 200, 200, 200, 200, 200, 200, 200, 200, 200, 200, 200, 200, 200, 200, 200, 200, 200, 200, 200, 200, 100, 100, 100, 100, 100, 100, 200, 200, 200, 200, 200, 200, 200, 200,
      200, 200, 200, 200, 200, 200, 200, 200, 200, 200, 200, 200, 100, 100, 200, 100, 100, 100, 100, 100, 100, 100, 100, 100, 100, 100, 100, 100, 100, 100, 100, 100, 200, 200, 200, 200, 200,
      200, 200, 200, 200, 200, 200, 200, 200, 200, 200, 100, 100, 200, 100, 100, 100, 200, 200, 200, 200, 200, 100, 100, 100, 200, 200, 200, 100, 100, 100, 200, 200, 100, 200, 200, 200, 200,
      200, 200, 200, 200, 200, 200, 200, 200, 200, 200, 100, 100, 100, 100, 100, 200, 200, 200, 200, 200, 200, 100, 210, 200, 200, 200, 200, 100, 100, 100, 100, 100, 100, 100, 200, 200, 200,
      200, 200, 200, 200, 200, 200, 200, 200, 200, 200, 110, 100, 100, 100, 100, 100, 200, 104, 104, 104, 210, 200, 200, 200, 200, 200, 200, 200, 200, 100, 100, 100, 100, 200, 200, 200, 200,
      200, 200, 200, 200, 200, 200, 200, 100, 100, 200, 210, 110, 100, 100, 100, 200, 200, 200, 104, 104, 104, 200, 200, 200, 200, 200, 200, 200, 200, 100, 100, 100, 100, 100, 200, 200, 200,
      200, 200, 200, 200, 200, 200, 200, 100, 100, 100, 100, 100, 200, 200, 200, 200, 104, 104, 104, 104, 104, 200, 200, 200, 200, 200, 200, 200, 200, 100, 200, 100, 100, 100, 200, 200, 200,
      200, 200, 200, 200, 200, 200, 200, 200, 100, 200, 100, 102, 200, 210, 102, 200, 200, 103, 200, 200, 104, 104, 200, 200, 200, 200, 200, 200, 200, 100, 100, 100, 100, 200, 200, 200, 200,
      200, 200, 200, 200, 200, 200, 200, 200, 100, 200, 100, 102, 102, 102, 102, 200, 102, 103, 200, 104, 104, 104, 104, 104, 200, 200, 200, 200, 200, 200, 100, 100, 100, 200, 200, 200, 200,
      200, 200, 200, 200, 200, 200, 200, 200, 100, 200, 100, 200, 200, 200, 102, 102, 102, 102, 200, 200, 104, 200, 104, 104, 104, 200, 210, 200, 200, 200, 100, 100, 100, 200, 200, 200, 200,
      200, 200, 200, 200, 200, 200, 200, 100, 100, 200, 100, 200, 200, 200, 200, 102, 102, 200, 200, 200, 200, 104, 104, 104, 200, 210, 104, 200, 200, 200, 100, 100, 100, 200, 200, 200, 200,
      200, 200, 200, 200, 200, 200, 100, 100, 100, 100, 100, 200, 100, 200, 200, 200, 101, 101, 200, 200, 200, 104, 104, 104, 104, 104, 104, 104, 104, 200, 100, 100, 200, 200, 200, 200, 200,
      200, 200, 200, 200, 200, 200, 100, 100, 100, 100, 100, 100, 100, 200, 100, 200, 101, 101, 200, 200, 200, 104, 104, 104, 104, 104, 104, 104, 104, 200, 100, 200, 200, 200, 200, 200, 200,
      200, 200, 200, 200, 200, 200, 100, 100, 100, 100, 200, 100, 100, 100, 100, 100, 101, 101, 200, 200, 200, 200, 104, 104, 104, 104, 104, 200, 104, 200, 100, 200, 200, 200, 200, 200, 200,
      200, 200, 200, 200, 200, 200, 200, 200, 200, 100, 100, 100, 100, 100, 100, 100, 100, 100, 200, 200, 200, 200, 104, 200, 104, 104, 104, 104, 104, 200, 100, 200, 200, 200, 200, 200, 200,
      200, 200, 200, 200, 200, 200, 200, 200, 200, 100, 100, 100, 100, 100, 100, 100, 100, 100, 200, 200, 200, 200, 200, 200, 200, 104, 200, 104, 200, 200, 100, 200, 200, 200, 200, 200, 200,
      200, 200, 200, 200, 200, 200, 200, 200, 200, 200, 200, 200, 100, 100, 100, 100, 100, 200, 200, 200, 200, 200, 200, 104, 210, 104, 210, 104, 200, 100, 100, 210, 200, 200, 200, 200, 200,
      200, 200, 200, 200, 200, 200, 200, 200, 200, 200, 200, 200, 100, 100, 200, 200, 200, 200, 200, 200, 200, 200, 200, 200, 104, 104, 104, 104, 200, 100, 100, 100, 100, 200, 200, 200, 200,
      200, 200, 200, 200, 200, 200, 200, 200, 200, 200, 200, 200, 100, 100, 200, 200, 200, 200, 200, 200, 200, 200, 200, 200, 200, 104, 104, 104, 200, 100, 100, 100, 100, 200, 200, 200, 200,
      200, 200, 200, 200, 200, 200, 200, 200, 200, 200, 200, 200, 100, 100, 200, 200, 200, 200, 200, 200, 200, 200, 200, 200, 200, 200, 200, 200, 200, 200, 110, 110, 200, 200, 200, 200, 200,
      200, 200, 200, 200, 200, 200, 200, 200, 200, 200, 200, 200, 100, 100, 200, 200, 200, 200, 200, 200, 200, 200, 200, 200, 200, 200, 200, 200, 200, 200, 100, 100, 200, 200, 200, 200, 200,
      200, 200, 200, 200, 200, 200, 200, 200, 200, 200, 200, 200, 120, 120, 200, 200, 200, 200, 200, 200, 200, 200, 200, 200, 200, 200, 200, 200, 200, 200, 120, 120, 200, 200, 200, 200, 200,
      200, 200, 200, 200, 200, 200, 200, 200, 200, 200, 200, 200, 200, 200, 200, 200, 200, 200, 200, 200, 200, 200, 200, 200, 200, 200, 200, 200, 200, 200, 200, 200, 200, 200, 200, 200, 200,
      200, 200, 200, 200, 200, 200, 200, 200, 200, 200, 200, 200, 200, 200, 200, 200, 200, 200, 200, 200, 200, 200, 200, 200, 200, 200, 200, 200, 200, 200, 200, 200, 200, 200, 200, 200, 200,
      200, 200, 200, 200, 200, 200, 200, 200, 200, 200, 200, 200, 200, 200, 200, 200, 200, 200, 200, 200, 200, 200, 200, 200, 200, 200, 200, 200, 200, 200, 200, 200, 200, 200, 200, 200, 200,
      200, 200, 200, 200, 200, 200, 200, 200, 200, 200, 200, 200, 200, 200, 200, 200, 200, 200, 200, 200, 200, 200, 200, 200, 200, 200, 200, 200, 200, 200, 200, 200, 200, 200, 200, 200, 200,
      200, 200, 200, 200, 200, 200, 200, 200, 200, 200, 200, 200, 200, 200, 200, 200, 200, 200, 200, 200, 200, 200, 200, 200, 200, 200, 200, 200, 200, 200, 200, 200, 200, 200, 200, 200, 200
    ],
  "content": {
    "10*": "walkable",
    "11*": "wevent",
    "20*": "unwalkable",
    "21*": "uevent",
    "*": "height"
  },
  "born": [31, 7],
  "NPC": [993, 503, 565, 986]
}
